0 0 0 0 0 0 0 0 0 0 0 0 0 0 0
0 0 0 0 0 0 0 0 0 0 0 0 0 0 0
0 0 0 0 0 0 0 0 0 0 0 0 0 0 0
0 0 0 0 0 1 1 2 1 1 0 0 0 0 0
0 0 0 0 0 2 2 2 2 2 0 0 0 0 0
0 0 0 0 0 2 2 2 2 2 0 0 0 0 0
0 0 0 0 0 1 1 2 1 1 0 0 0 0 0
0 0 0 0 0 0 0 0 0 0 0 0 0 0 0
0 0 0 0 0 0 0 0 0 0 0 0 0 0 0
0 0 0 0 0 0 0 0 0 0 0 0 0 0 0
#
3f 12f
3f 3f
2f 7.5f

17f 12f
17f 3f
19f 7.5f

7.5f 12f
12f  12f
10f  11f

7.5f 3f
12f  3f
10f  2f